7,7
6,1
6,3
0,0,0,0,0,0,0
0, , , , ,0,0
0, ,0, ,0,0,0
0, ,0, , , ,0
0, ,0, ,0,0,0
0, ,0, ,0,0,0
0, ,0, ,0,0,0