10,10
9,1
9,3
0,0,0,0,0,0,0,0,0,0
0, , , , , , ,0,0,0
0, ,0, ,0,0,0,0,0,0
0, ,0, , , , , ,0,0
0, ,0, ,0,0,0,0,0,0
0, ,0, ,0,0,0,0,0,0
0, ,0, , , , , ,0,0
0, ,0, ,0,0,0, ,0,0
0, ,0, ,0,0,0,0,0,0
0, ,0, ,0,0,0,0,0,0